#######################################
# Syntax Coloring Map
#######################################
#######################################
# # Datatypes (KEYWORD1)
#######################################
FLProgAbstractDisplay	KEYWORD1
FLProgAbstractDisplayScreen	KEYWORD1
FLProgAbstractField	KEYWORD1
FLProgAbstractTextDisplayField	KEYWORD1
FLProgAbstractTexttDisplay	KEYWORD1
FLProgBus4Display	KEYWORD1
FLProgBus8Display	KEYWORD1
FLProgI2c16bitDisplay	KEYWORD1
FLProgI2c8bitDisplay	KEYWORD1
FLProgSpiDisplay	KEYWORD1
FLProgSpnDisplay	KEYWORD1
FLProgTextDisplayScreen	KEYWORD1
FLProgTextDisplayTextField	KEYWORD1

#######################################
# Methods and Functions (KEYWORD2)
#######################################
addField	KEYWORD2
addScreen	KEYWORD2
address	KEYWORD2
blockShow	KEYWORD2
busNumber	KEYWORD2
coils	KEYWORD2
createScreen	KEYWORD2
csPin	KEYWORD2
d0Pin	KEYWORD2
d1Pin	KEYWORD2
d2Pin	KEYWORD2
d3Pin	KEYWORD2
d4Pin	KEYWORD2
d5Pin	KEYWORD2
d6Pin	KEYWORD2
d7Pin	KEYWORD2
ePin	KEYWORD2
enable	KEYWORD2
getTextBuffer	KEYWORD2
isNeedShow	KEYWORD2
misoPin	KEYWORD2
mosiPin	KEYWORD2
pool	KEYWORD2
resetEnable	KEYWORD2
resetIsNeedShow	KEYWORD2
restartPeriod	KEYWORD2
rows	KEYWORD2
rsPin	KEYWORD2
rwPin	KEYWORD2
sckPin	KEYWORD2
screenAt	KEYWORD2
setAddress	KEYWORD2
setBusNumber	KEYWORD2
setCoils	KEYWORD2
setCsPin	KEYWORD2
setD0Pin	KEYWORD2
setD1Pin	KEYWORD2
setD2Pin	KEYWORD2
setD3Pin	KEYWORD2
setD4Pin	KEYWORD2
setD5Pin	KEYWORD2
setD6Pin	KEYWORD2
setD7Pin	KEYWORD2
setEPin	KEYWORD2
setEnable	KEYWORD2
setEnableScreen	KEYWORD2
setFieldsCount	KEYWORD2
setIsNeedShow	KEYWORD2
setIsNeedShowAllFields	KEYWORD2
setMisoPin	KEYWORD2
setMosiPin	KEYWORD2
setPins	KEYWORD2
setRestartPeriod	KEYWORD2
setRows	KEYWORD2
setRsPin	KEYWORD2
setRwPin	KEYWORD2
setSckPin	KEYWORD2
setSpeed	KEYWORD2
speed	KEYWORD2
unBlockShow	KEYWORD2

#######################################
# Constants (LITERAL1)
#######################################
FLPROG_TEXT_DISPLAY_SEND_BUFFER_DATA_COMMAND	LITERAL1
FLPROG_TEXT_DISPLAY_SEND_BUFFER_INSTRUCTION_COMMAND	LITERAL1
FLPROG_TEXT_DISPLAY_SEND_BUFFER_SEND_DATA_STEP	LITERAL1
FLPROG_TEXT_DISPLAY_SEND_BUFFER_START_STEP	LITERAL1
FLPROG_TEXT_DISPLAY_SEND_BUFFER_TETRA_COMMAND	LITERAL1
FLPROG_TEXT_DISPLAY_SEND_BUFFER_WAIT_SET_CURSOR_STEP	LITERAL1